12 12 12 12 12 12 12 12 12 12 12 12 12 12 12 12 12 12 12 12 12 12 12 12 12 12 12 12 12 12 12 12 12 12 12 12 12 12 12 12 12 12 12 12 12 12 12 12 12 12 12 12 12 12 12 12 12 12 12 12
12 12 12 12 12 12 12 12 12 12 12 12 12 12 12 12 12 12 12 12 12 12 12 12 12 12 12 12 12 12 12 12 12 12 12 12 12 12 12 12 12 12 12 12 12 12 12 12 12 12 12 12 12 12 12 12 12 12 12 12
12 12 12 12 12 12 12 12 12 12 12 12 12 12 12 12 12 12 12 12 12 12 12 12 12 12 12 12 12 12 12 12 12 12 12 12 12 12 12 12 12 12 12 12 12 12 12 12 12 12 12 12 12 12 12 12 12 12 12 12
12 12 12 12 12 12 12 12 12 12 12 12 12 12 12 12 12 12 12 12 12 12 12 12 12 12 12 12 12 12 12 12 12 12 12 12 12 12 12 12 12 12 12 12 12 12 12 12 12 12 12 12 12 12 12 12 12 12 12 12
12 12 12 12 12 12 12 12 12 12 12 12 12 12 12 12 12 12 12 12 12 12 12 12 12 12 12 12 12 12 12 12 12 12 12 12 12 12 12 12 12 12 12 12 12 12 12 12 12 12 12 12 12 12 12 12 12 12 12 12
12 12 12 12 12 12 12 12 12 12 12 12 12 12 12 12 12 12 12 12 12 12 12 12 12 12 12 12 12 12 12 12 12 12 12 12 12 12 12 12 12 12 12 12 12 12 12 12 12 12 12 12 12 12 12 12 12 12 12 12
12 12 12 12 12 12 12 12 12 12 12 12 12 12 12 12 12 12 12 12 12 12 12 12 12 12 12 12 12 12 12 12 12 12 12 12 12 12 12 12 12 12 12 12 12 12 12 12 12 12 12 12 12 12 12 12 12 12 12 12
12 12 12 12 12 12 12 12 12 12 12 12 12 12 12 12 12 12 12 12 12 12 12 12 12 12 12 12 12 12 12 12 12 12 12 12 12 12 12 12 12 12 12 12 12 12 12 12 12 12 12 12 12 12 12 12 12 12 12 12
12 12 12 12 12 12 12 12 32 27 27 27 27 27 27 27 27 27 27 27 27 27 27 27 27 27 27 27 27 27 27 27 27 27 27 27 27 27 27 27 27 27 27 27 27 27 27 27 27 27 27 33 12 12 12 12 12 12 12 12
12 12 12 12 12 12 12 12 28 10 10 10 10 10 10 10 10 10 10 10 10 10 10 10 10 10 10 10 10 10 10 10 10 10 10 10 10 10 10 10 10 10 10 15 15 15 15 14 15 15 15 29 12 12 12 12 12 12 12 12
12 12 12 12 12 12 12 12 28 10 10 10 10 10 10 10 10 10 10 10 10 10 10 10 10 10 10 10 10 10 10 10 10 10 10 10 10 10 10 10 10 10 10 15 15 15 15 15 15 15 15 29 12 12 12 12 12 12 12 12
12 12 12 12 12 12 12 12 28 10 10 10 10 10 10 10 10 10 10 10 10 10 10 10 10 10 10 10 10 10 10 10 10 10 10 10 10 10 10 10 10 10 10 10 10 10 10 10 15 15 15 29 12 12 12 12 12 12 12 12
12 12 12 12 12 12 12 12 28 10 10 10 10 10 10 10 10 10 10 10 10 10 10 10 10 10 10 10 10 10 15 15 10 15 10 10 10 10 10 10 10 10 10 10 10 10 10 10 15 15 15 29 12 12 12 12 12 12 12 12
12 12 12 12 12 12 12 12 28 10 10 10 10 10 10 10 10 10 10 10 10 10 10 10 10 10 10 10 10 10 15 15 14 10 10 10 10 10 10 10 10 15 19 20 21 13 10 10 15 15 15 29 12 12 12 12 12 12 12 12
12 12 12 12 12 12 12 12 28 10 10 10 10 10 10 10 10 10 10 10 10 10 10 10 10 10 10 10 10 10 15 15 26 26 10 10 10 10 10 10 10 15 22 18 23 13 10 10 15 15 15 29 12 12 12 12 12 12 12 12
12 12 12 12 12 12 12 12 28 10 10 10 10 10 10 10 10 10 10 10 10 10 10 10 10 10 10 10 10 10 15 29 12 12 28 10 10 10 10 10 10 15 10 10 10 10 10 10 15 14 15 29 12 12 12 12 12 12 12 12
12 12 12 12 12 12 12 12 28 10 10 10 10 10 10 10 10 10 10 10 10 10 10 10 10 10 10 10 10 10 15 29 12 12 28 10 10 10 10 10 10 15 15 15 15 15 15 15 15 15 15 29 12 12 12 12 12 12 12 12
12 12 12 12 12 12 12 12 28 10 10 10 10 10 10 10 10 10 10 10 10 10 10 10 10 10 10 10 10 10 15 29 12 12 28 10 10 10 10 10 10 15 15 15 15 15 15 15 15 15 15 29 12 12 12 12 12 12 12 12
12 12 12 12 12 12 12 12 28 10 10 10 10 10 10 10 10 10 10 10 10 10 10 10 10 10 10 10 10 10 15 15 27 27 10 10 19 20 21 13 10 15 15 15 15 15 15 15 15 15 15 29 12 12 12 12 12 12 12 12
12 12 12 12 12 12 12 12 28 10 10 10 10 10 10 10 10 10 10 10 10 10 10 10 10 10 10 10 10 10 15 15 15 10 13 10 22 18 23 13 10 10 15 15 15 15 15 15 15 15 15 29 12 12 12 12 12 12 12 12
12 12 12 12 12 12 12 12 28 10 10 10 10 10 10 10 10 10 10 10 10 10 10 10 10 10 10 10 10 10 10 10 10 10 13 13 10 10 13 13 10 10 10 15 15 15 43 52 42 15 15 29 12 12 12 12 12 12 12 12
12 12 12 12 12 12 12 12 28 10 10 10 10 10 10 10 10 10 10 10 10 10 10 10 10 10 10 10 10 10 10 10 10 13 13 13 10 10 13 13 29 52 52 52 52 52 12 12 51 26 26 31 12 12 12 12 12 12 12 12
12 12 12 12 12 12 12 12 28 10 10 10 10 10 10 10 10 10 10 10 10 10 10 10 10 10 10 10 10 10 10 10 10 13 13 13 10 10 13 13 29 12 12 12 12 12 12 12 12 12 12 12 12 12 12 12 12 12 12 12
12 12 12 12 12 12 12 12 28 10 10 10 10 10 10 10 10 10 10 10 10 10 10 10 10 10 10 10 10 10 10 10 10 10 10 10 10 10 10 10 29 12 12 12 12 12 12 12 12 12 12 12 12 12 12 12 12 12 12 12
12 12 12 12 12 12 12 12 28 10 10 10 10 10 10 10 10 10 10 10 10 10 10 10 10 10 10 10 10 10 13 13 19 20 21 13 13 13 13 10 10 27 27 27 27 27 27 27 27 27 27 33 12 12 12 12 12 12 12 12
12 12 12 12 12 12 12 12 28 10 10 10 10 10 10 10 10 10 10 10 10 10 10 10 10 10 10 10 10 10 13 14 22 18 23 13 14 13 13 10 10 10 10 10 10 10 10 10 10 10 10 29 12 12 12 12 12 12 12 12
12 12 12 12 12 12 12 12 28 10 10 10 10 10 10 10 10 10 10 15 15 15 10 15 15 39 34 34 34 34 34 34 34 34 34 34 34 34 34 34 34 34 34 34 34 34 34 34 34 34 41 29 12 12 12 12 12 12 12 12
12 12 12 12 12 12 12 12 28 10 10 10 10 10 10 10 10 10 15 15 15 15 10 15 15 36 38 35 35 35 35 35 35 35 35 35 35 35 35 35 35 35 35 35 35 35 35 35 35 35 40 29 12 12 12 12 12 12 12 12
12 12 12 12 12 12 12 12 28 10 10 10 10 10 10 10 10 15 15 15 15 15 15 15 14 36 37 10 10 10 10 10 10 10 10 10 10 10 10 10 10 10 10 10 10 10 10 10 10 10 10 29 12 12 12 12 12 12 12 12
12 12 12 12 12 12 12 12 28 10 10 10 10 10 10 10 15 15 15 10 10 10 10 10 10 36 37 10 10 10 10 10 10 10 10 10 10 10 10 10 10 10 10 10 10 10 10 10 10 10 10 29 12 12 12 12 12 12 12 12
12 12 12 12 12 12 12 12 28 10 10 10 10 10 10 15 15 15 15 10 10 10 10 10 10 36 37 10 10 10 10 10 10 10 10 10 10 10 10 10 10 10 10 10 10 10 10 10 10 10 10 29 12 12 12 12 12 12 12 12
12 12 12 12 12 12 12 12 28 10 10 10 10 10 15 15 15 15 14 10 10 15 15 10 10 36 37 10 10 10 10 10 10 10 10 10 10 10 10 10 10 10 10 10 10 10 10 10 10 10 10 29 12 12 12 12 12 12 12 12
12 12 12 12 12 12 12 12 28 10 10 10 10 15 15 15 15 15 14 10 10 15 14 10 10 36 37 10 10 10 10 10 10 10 10 10 10 10 10 10 10 10 10 10 10 10 10 10 10 10 10 29 12 12 12 12 12 12 12 12
12 12 12 12 12 12 12 12 28 10 10 10 10 15 14 15 15 15 15 10 10 15 15 15 10 36 37 10 10 10 10 10 10 10 10 10 10 10 10 10 10 10 10 10 10 10 10 10 10 10 10 29 12 12 12 12 12 12 12 12
12 12 12 12 12 12 12 12 28 10 10 10 15 15 15 15 15 15 15 10 15 15 10 10 10 36 37 10 10 10 10 10 10 10 10 10 10 10 10 10 10 10 10 10 10 10 10 10 10 10 10 29 12 12 12 12 12 12 12 12
12 12 12 12 12 12 12 12 28 10 10 10 15 15 15 15 15 15 15 15 15 10 39 34 34 38 37 10 10 10 10 10 10 10 10 10 10 10 10 10 10 10 10 10 10 10 10 10 10 10 10 29 12 12 12 12 12 12 12 12
12 12 12 12 12 12 12 12 28 10 10 10 15 15 15 15 10 15 15 15 10 10 36 38 35 35 40 10 10 10 10 10 10 10 10 10 10 10 10 10 10 10 10 10 10 10 10 10 10 10 10 29 12 12 12 12 12 12 12 12
12 12 12 12 12 12 12 12 28 10 10 10 15 10 15 15 10 15 15 15 10 10 36 37 10 10 10 10 10 10 10 10 10 10 10 10 10 10 10 10 10 10 10 10 10 10 10 10 10 10 10 29 12 12 12 12 12 12 12 12
12 12 12 12 12 12 12 12 28 10 10 10 15 10 15 15 10 15 15 10 10 10 10 10 10 10 10 10 10 10 10 10 10 10 10 10 10 10 10 10 10 10 10 10 10 10 10 10 10 10 10 29 12 12 12 12 12 12 12 12
12 12 12 12 12 12 12 12 28 10 10 10 15 10 15 14 10 15 15 10 10 10 10 10 10 10 10 10 10 10 10 10 10 10 10 10 10 10 10 10 10 10 10 10 10 10 10 10 10 10 10 29 12 12 12 12 12 12 12 12
12 12 12 12 12 12 12 12 28 10 10 10 15 10 15 15 15 14 15 10 10 10 10 10 10 10 10 10 10 10 10 10 10 10 10 10 10 10 10 10 10 10 10 10 10 10 10 10 10 10 10 29 12 12 12 12 12 12 12 12
12 12 12 12 12 12 12 12 28 10 10 10 15 15 15 15 15 15 15 10 10 10 10 10 10 10 10 10 10 10 10 10 10 10 10 10 10 10 10 10 10 10 10 10 10 10 10 10 10 10 10 29 12 12 12 12 12 12 12 12
12 12 12 12 12 12 12 12 28 10 10 10 15 15 15 15 15 15 14 10 10 10 10 10 10 10 10 10 10 10 10 10 10 10 10 10 10 10 10 10 10 10 10 10 10 10 10 10 10 10 10 29 12 12 12 12 12 12 12 12
12 12 12 12 12 12 12 12 28 10 10 10 15 15 15 15 15 15 10 10 10 10 10 10 10 10 10 10 10 10 10 10 10 10 10 10 10 10 10 10 10 10 10 10 10 10 10 10 10 10 10 29 12 12 12 12 12 12 12 12
12 12 12 12 12 12 12 12 28 10 10 10 15 15 15 15 15 15 10 10 10 10 10 10 10 10 10 10 10 10 10 10 10 10 10 10 10 10 10 10 10 10 10 10 10 10 10 10 10 10 10 29 12 12 12 12 12 12 12 12
12 12 12 12 12 12 12 12 28 10 10 10 15 15 15 15 15 10 10 10 10 10 10 10 10 10 10 10 10 10 10 10 10 10 10 10 10 10 10 10 10 10 10 10 10 10 10 10 10 10 10 29 12 12 12 12 12 12 12 12
12 12 12 12 12 12 12 12 28 10 10 10 15 14 15 15 10 10 10 10 10 10 10 10 10 10 10 10 10 10 10 10 10 10 10 10 10 10 10 10 10 10 10 10 10 10 10 10 10 10 10 29 12 12 12 12 12 12 12 12
12 12 12 12 12 12 12 12 28 10 10 10 15 15 15 15 10 10 10 10 10 10 10 10 10 10 10 10 10 10 10 10 10 10 10 10 10 10 10 10 10 10 10 10 10 10 10 10 10 10 10 29 12 12 12 12 12 12 12 12
12 12 12 12 12 12 12 12 28 10 10 10 15 15 15 15 10 10 10 10 10 10 10 10 10 10 10 10 10 10 10 10 10 10 10 10 10 10 10 10 10 10 10 10 10 10 10 10 10 10 10 29 12 12 12 12 12 12 12 12
12 12 12 12 12 12 12 12 28 10 10 10 15 15 15 15 10 10 10 10 10 10 10 10 10 10 10 10 10 10 10 10 10 10 10 10 10 10 10 10 10 10 10 10 10 10 10 10 10 10 10 29 12 12 12 12 12 12 12 12
12 12 12 12 12 12 12 12 28 10 10 10 15 15 15 15 10 10 10 10 10 10 10 10 10 10 10 10 10 10 10 10 10 10 10 10 10 10 10 10 10 10 10 10 10 10 10 10 10 10 10 29 12 12 12 12 12 12 12 12
12 12 12 12 12 12 12 12 30 26 26 26 26 26 26 26 26 26 26 26 26 26 26 26 26 26 26 26 26 26 26 26 26 26 26 26 26 26 26 26 26 26 26 26 26 26 26 26 26 26 26 31 12 12 12 12 12 12 12 12
12 12 12 12 12 12 12 12 12 12 12 12 12 12 12 12 12 12 12 12 12 12 12 12 12 12 12 12 12 12 12 12 12 12 12 12 12 12 12 12 12 12 12 12 12 12 12 12 12 12 12 12 12 12 12 12 12 12 12 12
12 12 12 12 12 12 12 12 12 12 12 12 12 12 12 12 12 12 12 12 12 12 12 12 12 12 12 12 12 12 12 12 12 12 12 12 12 12 12 12 12 12 12 12 12 12 12 12 12 12 12 12 12 12 12 12 12 12 12 12
12 12 12 12 12 12 12 12 12 12 12 12 12 12 12 12 12 12 12 12 12 12 12 12 12 12 12 12 12 12 12 12 12 12 12 12 12 12 12 12 12 12 12 12 12 12 12 12 12 12 12 12 12 12 12 12 12 12 12 12
12 12 12 12 12 12 12 12 12 12 12 12 12 12 12 12 12 12 12 12 12 12 12 12 12 12 12 12 12 12 12 12 12 12 12 12 12 12 12 12 12 12 12 12 12 12 12 12 12 12 12 12 12 12 12 12 12 12 12 12
12 12 12 12 12 12 12 12 12 12 12 12 12 12 12 12 12 12 12 12 12 12 12 12 12 12 12 12 12 12 12 12 12 12 12 12 12 12 12 12 12 12 12 12 12 12 12 12 12 12 12 12 12 12 12 12 12 12 12 12
12 12 12 12 12 12 12 12 12 12 12 12 12 12 12 12 12 12 12 12 12 12 12 12 12 12 12 12 12 12 12 12 12 12 12 12 12 12 12 12 12 12 12 12 12 12 12 12 12 12 12 12 12 12 12 12 12 12 12 12
12 12 12 12 12 12 12 12 12 12 12 12 12 12 12 12 12 12 12 12 12 12 12 12 12 12 12 12 12 12 12 12 12 12 12 12 12 12 12 12 12 12 12 12 12 12 12 12 12 12 12 12 12 12 12 12 12 12 12 12
12 12 12 12 12 12 12 12 12 12 12 12 12 12 12 12 12 12 12 12 12 12 12 12 12 12 12 12 12 12 12 12 12 12 12 12 12 12 12 12 12 12 12 12 12 12 12 12 12 12 12 12 12 12 12 12 12 12 12 12
12 12 12 12 12 12 12 12 12 12 12 12 12 12 12 12 12 12 12 12 12 12 12 12 12 12 12 12 12 12 12 12 12 12 12 12 12 12 12 12 12 12 12 12 12 12 12 12 12 12 12 12 12 12 12 12 12 12 12 12
